1111111111111111
1000PC0100000001
100C0C0100CCC001
100000000E000001
1001110010001001
1000C0001000C001
1000000010001001
1111111111111111
