11111111
10000E01
100P0011
1CC00E01
11111111
