111111111111111111111111111111111111111111111
1C00000000000000000000P00000000000000000000C1
100011110011110011111000111110011110011110001
100011110011110010000000000010011110011110001
100011110011110010001101100010011110011110001
100B0000C0000000100011C1100010000000C00000001
1000000000C00000C1000110110001C00B0C000000001
100011110011111110001101100011111110011110001
100011110010000000000000000000000010011110001
10001111001000C000011111110000C00010011110001
100011110010000000011111110000000010011110001
10C0000000000111000000E0000001110000000000C01
10C0000000000111000000B00000011100000B0000C01
100011110010000000011111110000000010011110001
10001111001000C000011111110000C00010011110001
100011110010000000000000000000000010011110001
100011110011111110001101100011111110011110001
100000000C00000C1000110110001C00000C000000001
10000000C000B000100011C1100010000000C00000001
100011110011110010001101100010011110011110001
100011110011110010000000000010011110011110001
100011110011110011111000111110011110011110001
1C0000000000000000000000000000B000000000000C1
111111111111111111111111111111111111111111111
