111111111111
1000000P0001
111000000001
100C000C0011
10000E000001
100000000001
111111111111
