111111111111
100000000001
1110B000P001
100C00C00011
10000E000001
10000000B001
111111111111
